1111111111
1000100001
1011111001
1000000001
1011111001
1000100001
1010101111
1010101001
1110111001
1000000001
1011100001
1000100$01
1010111111
1010000001
1111111111
